basic_tiles.png
test.map
test.map
test.map
test.map
64
64
20
12
4, 5, 5, 5, 5, 5, 5, 5, 5, 5, 5, 5, 5, 5, 5, 5, 5, 5, 5, 3,
4, 1, 1, 1, 5, 1, 1, 1, 1, 1, 1, 1, 1, 1, 1, 1, 1, 1, 1, 5,
4, 1, 8, 1, 1, 1, 1, 1, 1, 1, 1, 1, 1, 1, 1, 1, 1, 1, 1, 4, 
4, 1, 1, 1, 4, 1, 1, 1, 1, 1, 1, 1, 1, 1, 1, 1, 1, 1, 1, 4,
4, 5, 5, 5, 5, 1, 1, 1, 1, 1, 1, 1, 1, 1, 1, 1, 1, 1, 1, 4, 
4, 1, 1, 1, 1, 1, 1, 1, 1, 1, 1, 1, 1, 1, 1, 1, 1, 1, 1, 4, 
4, 1, 1, 1, 1, 1, 1, 1, 1, 1, 1, 1, 1, 1, 5, 5, 5, 1, 4, 4, 
4, 1, 1, 1, 1, 1, 6, 1, 1, 1, 1, 1, 1, 1, 5, 1, 1, 1, 8, 4, 
4, 1, 1, 1, 1, 1, 1, 1, 1, 1, 1, 1, 1, 1, 5, 1, 1, 1, 1, 4, 
4, 1, 1, 1, 1, 1, 1, 1, 2, 2, 2, 1, 1, 1, 5, 1, 1, 9, 1, 4,
4, 1, 1, 1, 1, 1, 1, 1, 2, 2, 2, 1, 1, 1, 5, 1, 1, 1, 1, 4, 
5, 5, 5, 5, 5, 5, 2, 2, 2, 2, 2, 2, 2, 5, 5, 5, 5, 5, 5, 5